0 0 0 -9 -9 0 0 0 -8 -8 -8 -8 -9 -9 -9
0 0 0 -9 -9 0 0 0 0 0 0 0 0 0 -9
-18 0 0 0 0 0 0 0 0 -14 -14 0 0 0 -9
-18 0 0 -12 -12 0 0 0 0 -14 -14 0 0 0 0
-18 0 0 -12 -12 0 0 0 0 -14 -14 0 0 0 0
-18 0 0 0 0 0 0 0 0 0 0 0 0 0 0
-18 0 -5 -5 -5 -5 0 -22 -22 -22 0 0 0 0 -4
-18 0 0 0 0 0 0 -17 -17 -17 0 0 0 0 0
-16 0 0 -19 -19 0 0 0 0 0 0 0 0 0 0
-16 0 0 -19 -19 0 0 0 0 0 0 0 0 0 0
-16 0 0 0 0 0 0 0 0 -20 -20 0 -21 0 -15
-16 0 0 -10 -10 0 0 0 0 -20 -20 0 -21 0 -15
0 0 0 -10 -10 0 0 0 0 -20 -20 0 -21 0 -15
0 0 0 0 0 0 0 0 0 0 0 0 0 0 0
0 0 0 0 0 -2 0 0 0 -3 0 0 0 0 0