0 0 0 0 0 0 0 0 -8 0 0 0 0 0 0
0 0 0 -9 -9 0 0 0 0 0 0 0 0 0 0
0 0 0 0 0 0 0 0 0 0 0 0 0 0 0
0 0 0 -11 -12 0 0 0 0 0 0 0 0 0 0
0 0 0 -11 -12 0 0 0 0 0 0 0 0 0 0
0 0 0 0 0 0 0 0 0 0 0 0 0 0 0
0 0 0 0 0 0 0 0 0 0 0 0 0 0 -4
0 0 0 0 0 0 0 0 0 0 0 0 0 0 0
0 0 0 0 -19 -19 0 0 0 0 0 0 0 0 0
0 0 0 0 -19 -19 0 0 0 0 0 0 0 0 0
0 0 0 0 0 0 0 0 0 -20 -20 -20 0 0 0
0 0 0 0 0 0 0 0 0 -20 0 0 -21 0 -15
0 0 0 0 0 0 0 0 0 -20 -20 -20 0 0 0
0 0 0 0 0 0 0 0 0 0 0 0 0 0 0
0 0 0 0 0 -2 0 0 0 -3 0 0 0 0 0